########################################
#   #       # #       #  #       #     #
# # # ####### # ### #### ####### # ### #
# # # # @     #   #         @    # #   #
# # # # ##### ###@########### #### # # #
# # # # #         #         # #    # # #
# #   # # ## ###### ##### ### ###### # #  
##### # # #  #      @     #          ###
#   @     #    # ### ###### ########@# #
# ####### # #### #   #    #        # # #
# #     # #      # # # ## ## ##### #   #
# ##### # ##@### # # # #   # #   ##### #
#     # #    #   # # # # ### ###   # # #
####### #### # # # # # #    @  #@# # # #
#   #        # #   # # ##### ### # # # #
# # # ######## #@#######         # # # #
# # # @      # #        ########## # # #
# # # # # #### ######## #      #   # # #
# # # # #    #         ## ##@# # # #   #
# ### # # ## ## ######     # # # # #####
#   #   #      @     ##### # # # #     #
# # ############ # #     # # # # ##### #
# #   @  #       # # # #   # # #       #
# # # # ## ##### # # # # ### # # #####@#
# # # #  #         # # #     # # #   # #
### # ## #### ########@#### ## ### # # #
#   #       #     #         #      # # #
# ###### ####@### # ####### # ###### # #
#                 #       #   #        #
############################### ########