####################
#      #     #     #
# #### ##### # ### #
# #    #     #   # #
# ### #### ###@### #
#   #    @         #
### ##### # ########
  #     # #        #
# # ###@# #@## #####
# # #        # @   #
# # #### # # # ### #
# #    # # #   #   #
# #### # # # ### # #
#    ### #@###   # #
#### @   #     ### #
#    #########    @#
# ####       ##### #
# # # ###### #   # #
#   #        @ #   #
####################