########################################
#   #     #       #       #          # #
# # # ### ### ### # ########### ###### #
# # #   # @ # # # #             #    # #
# # ### # # # # # # ##### #########@## #
# #   # # # # # # # #   #   #          #
##### ### # # # # # # # # # # ######## #
# @ #     # # #   # # # # # #        # #
# # ####### # # ### # # # # ### ###### #
# #         # #       # # #          # #
# ######### # ### ##### ####### # # ## #
# #       # #   # #    @    #   # #    #
# # ####### ### # ######### # ### # ####
# # #       @ # #         # # #   #    #
# # # ####### # # ####### # # ##### ## #
# # #       #   # #         #      @ # #
# # ####### ##### # ####### # # #### # #
# #               # #     # # # #    # #
# # ######## ####@# ##### # # # # ## # #
# #   #    #    # #     # # @ # # #  # #
# ###@# ####### # ##### # # ### # # ## #
#     #       # #     # # # #   # #    #
##### ##### ### ####### # # # ##########
# # # #   # #           # # #          #
# # # ### # # ######### # # ############
# # #     # @ #         # #          # #
# # ####### ### ######### ############ #
# #         # # #     @ #     #   #  # #
# ######### # # # ##### ##### # # # ## #
#       # # #     #   #     # # # # #  #
# ##### # # ##### # # # ### # # # # # ##
###   # # #       # # # # # # # # # # ##
    # # # ####### # # # # # # # # # # ##
### # # #       # # # # #   # # # # #@##
# # # # ####### #@# # # ##### # # #    #
# # # # #       # # # # #   # # # ## # #
# # # # # # ##### # # # # # #      # # #
# # # #@# # # # # # # # # # ###### # # #
#   #     #   #     # #   #   @    #   #
########################################