###############
#       #   # #
#@##### # # # #
#   # # # # # #
# ### # # #   #
#     #@# ### #
#######     # #
#       ###@###
#@#######     #
#       # # # #
# ##### # # # #
# #     # # # #
# ## #@## ### #
#  # #        #
#### ##########
