########################################
#   #     #       #       #          # #
# # # ### ### ### # ########### ###### #
# # #   #   # # # #             #    # #
# # ### # # # # # # ##### ######### ## #
# #   # # # # # # # #   #   #          #
##### ### # # # # # # # # # # ######## #
#   #     # # #   # # # # # #        # #
# #@####### # # ### # # # # ### ###### #
# #         # #       # # #          # #
# ######### # ### #####@####### # # ## #
# #       # #   # #         #   # #    #
# # ####### ### # ######### # ### # ####
# # #         # #         # # #   #    #
# #@# ####### # # ####### # # ##### ## #
# # #       #   # #  @      #        # #
# # ####### ##### # ####### # # #### # #
# #               # #     # # # #    # #
# # ######## #### # ##### # # # # ## # #
#@#   #    #    # #     # #   # # #  # #
# ### # ####### # ##### # # ### # # ## #
#     #       # #     # # # #   # #    #
# ### ##### ### ####### # # # ##########
#@# # #   # #           # # #          #
# # # ### #@# #########@# # ############
# # #     #   #         # #          # #
# # ####### ### ######### ############ #
# #         # # #       #     #   #    #
# ####### # # # # #####@##### # # # ## #
#       # # #     #   #     # # # # #  #
# ##### # # ##### # # # ### # # # # # ##
###   # # #       # # # # # # # # # # ##
    # # # ####### # # # # # # # # # # ##
### # # #       # # #@# #   # # # # # ##
# # # # ####### # # # # ##### # # #    #
# # # # #       # # # # #   # # # ## # #
# # # # # # ##### # # # # # #      # # #
# # # # # # # #   # # # # # ###### # # #
#   #     #   #     # #   #        #   #
########################################