##############################
#   #       # #        #     #
# # # ####### # ###### # ### #
# # # # @     #   #    # #   #
# # # # ##### ###@# #### # # #
# # # # #         # #    # # #
# #   # # ## ###### ###### #  
##### # # #  #             ###
#   @     #    # #########@# #
# ####### # #### #       # # #
# #     # #      # ##### #   #
# ##### # ##@### # #   ##### #
#     # #    #   # ###   # # #
####### #### # # #   #@# # # #
#   #        # #   ### # # # #
# # # ######## #@##    # # # #
# # # @      # #   ##### # # #
# # # # # #### ###   #   # # #
# # # # #    #     # # # #   #
# ### # # ## ## #### # # #####
#   #   #      @   # # #     #
# # ############ # # # ##### #
# #   @  #       # # #       #
# # # # ## ##### # # # #####@#
# # # #  #         # # #   # #
### # ## #### ###### ### # # #
#   #       #     #      # # #
# ###### ####@### # ###### # #
#                 # #        #
##############################